--------ooooooo
--------ooooooo
--------ooooooo
--------ooooooo
---------------
---------------
---------------
---------------
----------#####
----------#####
----------#####
----------#####
---------------
---------------
---------------
---------------
^^^^^----------
^^^^^----------
^^^^^----------
^^^^^----------